TEXTURES
{
	text_north	 : HEXA, 0xD62828
	text_west	 : HEXA, 0xBC6C25
	text_south	 : HEXA, 0x8B4513
	text_est	 : HEXA, 0xF4A261
	text_floor	 : PATH, ./tex.xpm
	text_ceiling : PATH, ./tex.xpm
	text_front	 : PATH, ./tex.xpm
	text_back	 : PATH, ./tex.xpm
	text_side	 : HEXA, 0xfff000
	text_player	 : PATH, ./tex.xpm
	monster_tex  : HEXA, 0x000fff
	tree_tex	 : PATH, ./tex.xpm
}
WALLS
{
	K	: text_north, text_west, text_south, text_est
	1	: text_north, text_west, text_south, text_est
	2	: text_north, text_west, text_south, text_est
	3	: text_north, text_west, text_south, text_est
	4	: text_north, text_west, text_south, text_est
	5	: text_north, text_west, text_south, text_est
}
AIRS
{
	o	: text_floor, text_ceiling
	k	: text_floor, text_ceiling
	0	: text_floor, text_ceiling
	A	: text_floor, text_ceiling
}
DOORS
{
	d	: 1, text_front, text_back, text_side
	a	: 0, text_front, text_back, text_side
	D	: 1, text_front, text_back, text_side
}
MONSTERS
{
	M : 100%, 10, monster_tex
	m : 50%, 5, monster_tex
}
OBJECTS
{
	T : 50%, tree_tex
}
PLAYERS
{
	N : N, text_player
	S : S, text_player
	E : E, text_player
	W : W, text_player
}
MANDATORY_MAP
{
         111111111111111111111111
        10000000001100000000000m1
        1011000001110000M00000001
        1001000000D00000000000001
111111111011000001110000000000001
1T0000000011000001110111110111111
11110111111111011100000010001
1111a111111111011101010010001
1100000011N10101110000M010001
10000000000000001100000010001
10000000000000001101010010001
1100000111010101111101101000111
11110111 1110101 101111010001
11111111 1111111 111111111111
}
BONUS_MAP
{
         111111111111111111111111
        10000000001100000000000A1
        1011000001110000000000001
        1001000000000000000000001
111111111011000001110000000000001
100000000011000001110111110111111
11110111111111011100000010001
11110111111111011101010010001
11000000110101011100000010001
10000000000000001100000010001
10000000000000001101010010001
1100000111010101111101101000111
11110111 1110101 101111010001
11111111 1111111 111111111111
}
